 '---------------------------------------------------------------------------------------------------------------------------------------------'
 '-                            -   -    ----                                                                                                  -'
 '-           ????             -- --      -                                                    ?                                              -'
 '-                            - - -     -                                                                                                    -'
 '-                            -   -    ----                                                                                                  -'
 '-           ----                                                                        ?    ?   ?                                          -'
 '-                                                                                                            -                              -'
 '-                                                           -------------?---  -    -----------------              -                        -'
 '-                                                                                                            ?                              -'
 '-     -      -      -                 ?                                            -                                                        -'
 '-                                      ?                                      -                                                             -'
 '-        ---------                                                       -            -      ?-------------                                 -'
 '-                                                      --?         ---                                     --                               -'
 '-                                                                                                            --                             -'
 '-     --           --             -   -       --                                                               --                           -'
 '-                                --   -                   --                      -------------                                              '
 '-                               ---   -                 ------                                --                                             '
 '-----------------------------------   -------------------------------------------------------------------------------------------------------'