----------------------------------------
--                                    -- 
-- -----    -    ----     -    ----   -- 
--   =-    -=-   -===-   -=-   -===-  --
--  +-    -===-  -===-  -===-  -===-  --
--  -=    -----  ----+  -----  ----=  --
-- -----  -   -  -      -   -  -   -  --
--                                    -- 
----- --  -   -    -    -   -  ----  ---    
--        --+--   -=-    -=-          --
--  ----  -=-=-  -===-   =-=+----  -----             
--        -   -  -----   -=-          --    
-------   -   -  -   -  -   -  ---  ----    
--+                                   -- 
-------   ---------==----------   ------
-                -====-                -
----   -----------====----------  ------
-               +------+               -
----  --------------     ---   ---  ----
-                                      -
-----------  ---------------   ---------
-+                                     -
---  ------------- + --------------   --
-                                +     -
---------  -------------     -----------
-                 +                    -
---------------     -------------  -----
-                                      -
----   -----------------   -------------
-                  +                   -
----------------------------------------
-======================================-
----------------------------------------