 '--------------------'
 '-                  -'
 '-                  -'
 '-                  -'
 '-                  -'
 '-           ----   -'
 '-                  -'
 '-                  -'
 '-            -     -'
 '-     -            -'
 '-                  -'
 '-        --------- -'
'---------------------'