----------------------------------------
--                                    -- 
-- -----    -    ----     -    ----   -- 
--    -    - -   -   -   - -   -   -  --
--   -    -   -  -   -  -   -  -   -  --
--  -     -----  ----   -----  ----   --
-- -----  -   -  -      -   -  -   -  --
--                                    -- 
----- --  -   -    -    -   -  ----  ---    
--        -- --   - -    - -          --
--  ----  - - -  -   -    -  ----  -----             
--        -   -  -----   - -          --    
-------   -   -  -   -  -   -  ---  ----    
--                                    -- 
-------   ---------  ----------   ------
-                -    -                -
----   -----------    ----------  ------
-                ------                -
----  --------------     ---   ---  ----
-                                      -
-----------  ---------------   ---------
-                                      -
---  -------------   --------------   --
-                                      -
---------  -------------     -----------
-                                      -
---------------     -------------  -----
-                                      -
----   -----------------   -------------
-                                      -
----------------------------------------
-                                      -
----------------------------------------