----------------------------------------
-                                      -
-------   -------------- --------------- 
-                                      - 
------------------     -----------------
-                                      -
-------------        -------------------
-                                      -
--------------  -----------    ---------
-     -         ----                   -
---  ---------  ---------------    -----
-        -----  --                     -
-------   ----           ------   ------
-                ----------            -
----   -------------------------- ------
-                        -----         -
--------------------     ---   ---  ----
-                                      -
----------------------------------------
-                                      -
----------------------------------------
-                                      -
----------------------------------------
-                                      -
----------------------------------------
-                                      -
----------------------------------------
-                                      -
----------------------------------------
-                                      -
----------------------------------------
-                                      -
----------------------------------------