----------------------------------------
-......................................-
-------...--------------.--------------- 
-......................................- 
------------------     -----------------
-                                      -
-------------        -------------------
-......................................-
--------------  -----------    ---------
-     -         ----                   -
---  ---------  ---------------    -----
-        -----  --                     -
-------   ----           ------   ------
-                ----------            -
----   -------------------------- ------
-                        -----         -
--------------------     ---   ---  ----
-                                      -
----------------------------------------
-                                      -
----------------------------------------
-                                      -
----------------------------------------
-                                      -
----------------------------------------
-                                      -
----------------------------------------
-                                      -
----------------------------------------
-                                      -
----------------------------------------
-                                      -
----------------------------------------